"filename", "language", "Batch", "Java", "XML", "Java Properties", "comment", "blank", "total"
"d:\KhoiDz\package-manager\package-manager-be\.mvn\wrapper\maven-wrapper.properties", "Java Properties", 0, 0, 0, 2, 0, 1, 3
"d:\KhoiDz\package-manager\package-manager-be\mvnw.cmd", "Batch", 118, 0, 0, 0, 51, 37, 206
"d:\KhoiDz\package-manager\package-manager-be\pom.xml", "XML", 0, 0, 72, 0, 0, 9, 81
"d:\KhoiDz\package-manager\package-manager-be\src\main\java\com\mbamc\packagemanagerbe\PackageManagerBeApplication.java", "Java", 0, 15, 0, 0, 0, 6, 21
"d:\KhoiDz\package-manager\package-manager-be\src\main\java\com\mbamc\packagemanagerbe\config\WebConfig.java", "Java", 0, 15, 0, 0, 41, 3, 59
"d:\KhoiDz\package-manager\package-manager-be\src\main\java\com\mbamc\packagemanagerbe\controller\AuthController.java", "Java", 0, 7, 0, 0, 0, 3, 10
"d:\KhoiDz\package-manager\package-manager-be\src\main\java\com\mbamc\packagemanagerbe\controller\PackageController.java", "Java", 0, 97, 0, 0, 4, 20, 121
"d:\KhoiDz\package-manager\package-manager-be\src\main\java\com\mbamc\packagemanagerbe\controller\StatisticsController.java", "Java", 0, 54, 0, 0, 0, 11, 65
"d:\KhoiDz\package-manager\package-manager-be\src\main\java\com\mbamc\packagemanagerbe\controller\UploadController.java", "Java", 0, 35, 0, 0, 0, 6, 41
"d:\KhoiDz\package-manager\package-manager-be\src\main\java\com\mbamc\packagemanagerbe\converter\PackageConverter.java", "Java", 0, 43, 0, 0, 0, 6, 49
"d:\KhoiDz\package-manager\package-manager-be\src\main\java\com\mbamc\packagemanagerbe\converter\StatisticsConverter.java", "Java", 0, 23, 0, 0, 7, 6, 36
"d:\KhoiDz\package-manager\package-manager-be\src\main\java\com\mbamc\packagemanagerbe\dto\statistics\bar\BarChartDto.java", "Java", 0, 16, 0, 0, 0, 5, 21
"d:\KhoiDz\package-manager\package-manager-be\src\main\java\com\mbamc\packagemanagerbe\dto\statistics\bar\PriConQuery.java", "Java", 0, 15, 0, 0, 0, 3, 18
"d:\KhoiDz\package-manager\package-manager-be\src\main\java\com\mbamc\packagemanagerbe\dto\statistics\line\DepartmentWithCount.java", "Java", 0, 13, 0, 0, 0, 8, 21
"d:\KhoiDz\package-manager\package-manager-be\src\main\java\com\mbamc\packagemanagerbe\dto\statistics\line\LineChartDto.java", "Java", 0, 12, 0, 0, 0, 4, 16
"d:\KhoiDz\package-manager\package-manager-be\src\main\java\com\mbamc\packagemanagerbe\dto\statistics\line\LineChartPoint.java", "Java", 0, 8, 0, 0, 0, 4, 12
"d:\KhoiDz\package-manager\package-manager-be\src\main\java\com\mbamc\packagemanagerbe\dto\statistics\pie\LineChartQuery.java", "Java", 0, 14, 0, 0, 0, 3, 17
"d:\KhoiDz\package-manager\package-manager-be\src\main\java\com\mbamc\packagemanagerbe\dto\statistics\pie\PieChartDto.java", "Java", 0, 12, 0, 0, 0, 3, 15
"d:\KhoiDz\package-manager\package-manager-be\src\main\java\com\mbamc\packagemanagerbe\dto\tables\HighestByDateDto.java", "Java", 0, 14, 0, 0, 0, 4, 18
"d:\KhoiDz\package-manager\package-manager-be\src\main\java\com\mbamc\packagemanagerbe\dto\tables\HighestByDepartmentByDate.java", "Java", 0, 13, 0, 0, 0, 3, 16
"d:\KhoiDz\package-manager\package-manager-be\src\main\java\com\mbamc\packagemanagerbe\dto\tables\PackageDto.java", "Java", 0, 21, 0, 0, 0, 4, 25
"d:\KhoiDz\package-manager\package-manager-be\src\main\java\com\mbamc\packagemanagerbe\dto\tables\UserDto.java", "Java", 0, 11, 0, 0, 0, 4, 15
"d:\KhoiDz\package-manager\package-manager-be\src\main\java\com\mbamc\packagemanagerbe\model\Package.java", "Java", 0, 39, 0, 0, 0, 11, 50
"d:\KhoiDz\package-manager\package-manager-be\src\main\java\com\mbamc\packagemanagerbe\model\User.java", "Java", 0, 22, 0, 0, 0, 10, 32
"d:\KhoiDz\package-manager\package-manager-be\src\main\java\com\mbamc\packagemanagerbe\repository\PackageRepository.java", "Java", 0, 28, 0, 0, 0, 7, 35
"d:\KhoiDz\package-manager\package-manager-be\src\main\java\com\mbamc\packagemanagerbe\repository\StatisticsRepository.java", "Java", 0, 38, 0, 0, 0, 10, 48
"d:\KhoiDz\package-manager\package-manager-be\src\main\java\com\mbamc\packagemanagerbe\repository\UserRepository.java", "Java", 0, 11, 0, 0, 0, 3, 14
"d:\KhoiDz\package-manager\package-manager-be\src\main\java\com\mbamc\packagemanagerbe\service\AuthService.java", "Java", 0, 3, 0, 0, 0, 2, 5
"d:\KhoiDz\package-manager\package-manager-be\src\main\java\com\mbamc\packagemanagerbe\service\PackageService.java", "Java", 0, 44, 0, 0, 4, 15, 63
"d:\KhoiDz\package-manager\package-manager-be\src\main\java\com\mbamc\packagemanagerbe\service\StatisticsService.java", "Java", 0, 75, 0, 0, 0, 18, 93
"d:\KhoiDz\package-manager\package-manager-be\src\main\java\com\mbamc\packagemanagerbe\service\UploadService.java", "Java", 0, 27, 0, 0, 0, 5, 32
"d:\KhoiDz\package-manager\package-manager-be\src\main\java\com\mbamc\packagemanagerbe\service\UserService.java", "Java", 0, 19, 0, 0, 0, 6, 25
"d:\KhoiDz\package-manager\package-manager-be\src\main\java\com\mbamc\packagemanagerbe\util\PackageExcelHandler.java", "Java", 0, 147, 0, 0, 1, 25, 173
"d:\KhoiDz\package-manager\package-manager-be\src\main\resources\application.properties", "Java Properties", 0, 0, 0, 8, 3, 0, 11
"d:\KhoiDz\package-manager\package-manager-be\src\test\java\com\mbamc\packagemanagerbe\PackageManagerBeApplicationTests.java", "Java", 0, 9, 0, 0, 0, 5, 14
"Total", "-", 118, 900, 72, 10, 111, 270, 1481